//MAP CONVERTED BY dmm2tgm.py THIS HEADER COMMENT PREVENTS RECONVERSION, DO NOT REMOVE
"bh" = (
/obj/structure/fluff/statue/knight/interior,
/turf/open/floor/rogue/hexstone)
"bz" = (
/obj/structure/table/wood/crafted,
/obj/item/rogueweapon/huntingknife/cleaver,
/turf/open/floor/rogue/herringbone)
"bD" = (
/obj/structure/fluff/statue/evil,
/turf/open/floor/rogue/hexstone)
"dw" = (
/obj/structure/closet/crate/chest,
/obj/item/reagent_containers/food/snacks/grown/wheat,
/obj/item/reagent_containers/food/snacks/grown/wheat,
/obj/item/reagent_containers/food/snacks/grown/wheat,
/obj/item/reagent_containers/food/snacks/grown/wheat,
/obj/item/reagent_containers/food/snacks/grown/wheat,
/obj/item/reagent_containers/food/snacks/grown/wheat,
/obj/item/reagent_containers/food/snacks/grown/wheat,
/obj/item/reagent_containers/food/snacks/grown/wheat,
/obj/item/reagent_containers/food/snacks/grown/wheat,
/turf/open/floor/rogue/herringbone)
"gj" = (
/obj/structure/well,
/turf/open/floor/rogue/dirt)
"hf" = (
/obj/structure/roguewindow/openclose{
	dir = 4
	},
/turf/open/floor/rogue/herringbone)
"iJ" = (
/turf/open/floor/rogue/herringbone)
"jn" = (
/turf/open/floor/carpet/red)
"kG" = (
/obj/effect/dungeon_directional_helper/west,
/turf/open/floor/rogue/naturalstone)
"lo" = (
/obj/structure/bed/rogue/inn,
/obj/machinery/light/rogue/torchholder/c,
/turf/open/floor/rogue/herringbone)
"ls" = (
/obj/structure/table/church{
	dir = 1
	},
/obj/item/reagent_containers/food/snacks/rogue/crackerscooked{
	pixel_x = 8;
	pixel_y = 12
	},
/obj/item/reagent_containers/food/snacks/rogue/crackerscooked{
	pixel_x = 2;
	pixel_y = 4
	},
/obj/item/reagent_containers/food/snacks/rogue/crackerscooked{
	pixel_x = -7;
	pixel_y = 11
	},
/turf/open/floor/rogue/hexstone)
"lU" = (
/turf/open/floor/rogue/dirt)
"mf" = (
/obj/machinery/light/rogue/torchholder/l,
/turf/open/floor/rogue/hexstone)
"mM" = (
/obj/machinery/light/rogue/firebowl,
/turf/open/floor/rogue/dirt)
"mT" = (
/turf/closed/mineral/rogue/bedrock)
"no" = (
/obj/structure/table/wood/crafted,
/obj/item/millstone,
/turf/open/floor/rogue/herringbone)
"ns" = (
/obj/structure/roguewindow/openclose,
/turf/open/floor/rogue/herringbone)
"nG" = (
/obj/structure/fermentation_keg/random/beer,
/turf/open/floor/rogue/herringbone)
"wE" = (
/obj/machinery/light/rogue/hearth,
/obj/item/cooking/pan,
/turf/open/floor/rogue/herringbone)
"yi" = (
/obj/structure/fluff/statue/knightalt,
/turf/open/floor/rogue/hexstone)
"yn" = (
/obj/machinery/light/rogue/firebowl,
/turf/open/floor/rogue/naturalstone)
"zz" = (
/obj/structure/closet/crate/chest,
/obj/item/seeds/wheat,
/obj/item/seeds/wheat,
/obj/item/seeds/wheat,
/obj/item/seeds/wheat,
/obj/item/seeds/wheat,
/obj/item/seeds/wheat,
/obj/item/seeds/wheat,
/obj/item/rogueweapon/hoe,
/obj/item/rogueweapon/sickle,
/obj/item/rogueweapon/thresher,
/obj/item/seeds/onion,
/obj/item/seeds/onion,
/obj/item/seeds/onion,
/obj/item/seeds/onion,
/obj/item/seeds/onion,
/obj/item/seeds/onion,
/obj/item/seeds/cabbage,
/obj/item/seeds/cabbage,
/obj/item/seeds/cabbage,
/obj/item/seeds/cabbage,
/obj/item/seeds/apple,
/obj/item/seeds/apple,
/obj/item/seeds/apple,
/turf/open/floor/rogue/dirt)
"AT" = (
/obj/structure/fermentation_keg/random/water,
/turf/open/floor/rogue/herringbone)
"Bv" = (
/obj/structure/table/church,
/obj/item/flashlight/flare/torch/metal{
	pixel_y = 7
	},
/obj/item/flashlight/flare/torch/metal{
	pixel_y = 6;
	pixel_x = -8
	},
/obj/item/flashlight/flare/torch/metal{
	pixel_x = 7;
	pixel_y = 6
	},
/turf/open/floor/rogue/hexstone)
"BZ" = (
/obj/machinery/light/rogue/oven/east,
/turf/open/floor/rogue/herringbone)
"Ca" = (
/obj/structure/closet/crate/chest/crafted,
/turf/open/floor/rogue/hexstone)
"Cn" = (
/obj/structure/stairs/stone{
	dir = 1
	},
/turf/open/floor/rogue/herringbone)
"Ef" = (
/obj/effect/dungeon_directional_helper/north,
/turf/open/floor/rogue/naturalstone)
"FY" = (
/obj/structure/dungeon_exit,
/turf/open/floor/rogue/herringbone)
"Gi" = (
/obj/structure/fluff/statue/knightalt/r,
/turf/open/floor/rogue/hexstone)
"GM" = (
/turf/open/floor/rogue/hexstone)
"Hl" = (
/obj/structure/roguewindow/openclose{
	dir = 1
	},
/turf/open/floor/rogue/herringbone)
"Hw" = (
/turf/closed/mineral/rogue)
"LD" = (
/obj/item/reagent_containers/glass/bucket,
/turf/open/floor/rogue/dirt)
"Ma" = (
/obj/effect/decal/cleanable/blood,
/turf/open/floor/rogue/hexstone)
"Mh" = (
/obj/structure/table/wood/crafted,
/turf/open/floor/rogue/herringbone)
"Mq" = (
/obj/structure/table/church/m,
/obj/item/reagent_containers/glass/bottle/waterskin{
	pixel_y = -1;
	pixel_x = -5
	},
/obj/item/reagent_containers/glass/bottle/waterskin{
	pixel_y = 3
	},
/obj/item/reagent_containers/glass/bottle/waterskin{
	pixel_x = 8;
	pixel_y = 7
	},
/turf/open/floor/rogue/hexstone)
"Oo" = (
/obj/machinery/light/rogue/firebowl,
/turf/open/floor/rogue/hexstone)
"OY" = (
/obj/structure/stairs/stone{
	dir = 1
	},
/turf/open/floor/rogue/hexstone)
"Pp" = (
/obj/machinery/light/rogue/hearth,
/obj/item/reagent_containers/glass/bucket/pot,
/turf/open/floor/rogue/herringbone)
"QX" = (
/obj/effect/dungeon_directional_helper/south,
/turf/open/floor/rogue/naturalstone)
"Re" = (
/obj/machinery/light/rogue/torchholder/c,
/turf/open/floor/rogue/herringbone)
"Rf" = (
/obj/structure/roguewindow/openclose{
	dir = 8
	},
/turf/open/floor/rogue/herringbone)
"RX" = (
/obj/structure/mineral_door/wood,
/turf/open/floor/rogue/herringbone)
"Sc" = (
/turf/open/transparent/openspace)
"UE" = (
/turf/closed/wall/mineral/rogue/stone,
/area/rogue)
"Ve" = (
/obj/structure/closet/crate/drawer/inn,
/obj/item/clothing/suit/roguetown/shirt/tunic,
/turf/open/floor/rogue/herringbone)
"Vp" = (
/turf/open/floor/rogue/naturalstone)
"Xo" = (
/obj/structure/gate/preopen,
/turf/open/floor/rogue/hexstone)
"Xz" = (
/obj/structure/fluff/statue/knight/interior/r,
/turf/open/floor/rogue/hexstone)
"XC" = (
/obj/structure/closet/crate/drawer/inn,
/turf/open/floor/rogue/herringbone)

(1,1,1) = {"
mT
mT
mT
mT
mT
mT
mT
mT
mT
mT
mT
mT
mT
mT
Vp
Vp
kG
Vp
Vp
Vp
mT
mT
mT
mT
mT
mT
mT
mT
mT
mT
mT
mT
mT
mT
mT
"}
(2,1,1) = {"
mT
Vp
Vp
Vp
Vp
mT
mT
mT
Vp
Vp
Vp
Vp
Vp
Vp
Vp
Vp
Vp
Vp
Vp
Vp
Vp
Vp
Vp
Vp
Vp
Vp
Vp
mT
mT
mT
mT
mT
mT
mT
mT
"}
(3,1,1) = {"
mT
Vp
Vp
Vp
mT
mT
Vp
Vp
Vp
Vp
Vp
Vp
Vp
Vp
Vp
Vp
Vp
Vp
Vp
Vp
Vp
Vp
Vp
Vp
Vp
Vp
Vp
Vp
mT
mT
mT
mT
mT
mT
mT
"}
(4,1,1) = {"
mT
mT
Vp
mT
mT
Vp
Vp
Vp
Vp
lU
lU
lU
Vp
Vp
Vp
lU
Vp
Vp
Vp
Vp
lU
Vp
lU
Vp
lU
mM
lU
Vp
Vp
mT
mT
mT
mT
mT
Vp
"}
(5,1,1) = {"
mT
mT
Vp
Vp
Vp
Vp
Vp
Vp
lU
lU
lU
lU
lU
Vp
lU
lU
lU
Vp
Vp
lU
lU
lU
lU
lU
lU
lU
lU
Vp
Vp
Vp
mT
mT
mT
Vp
Vp
"}
(6,1,1) = {"
mT
mT
mT
Vp
Vp
Vp
Vp
Vp
lU
lU
lU
lU
lU
lU
lU
lU
lU
lU
lU
Hw
Hw
Hw
Hw
Hw
lU
lU
lU
lU
Vp
Vp
Vp
Vp
Vp
Vp
Vp
"}
(7,1,1) = {"
Vp
Vp
Vp
Vp
Vp
Vp
Vp
Vp
lU
lU
lU
Hw
Hw
Hw
Hw
Hw
lU
lU
lU
Hw
OY
GM
mf
Hw
zz
lU
lU
lU
lU
Vp
Vp
Vp
Vp
Vp
Vp
"}
(8,1,1) = {"
Vp
Vp
Vp
Vp
Vp
Vp
Vp
Vp
lU
lU
lU
Hw
Oo
GM
GM
Hw
Hw
Hw
Hw
Hw
OY
GM
GM
Hw
LD
lU
lU
lU
lU
Vp
Vp
Vp
Vp
Vp
QX
"}
(9,1,1) = {"
Vp
Vp
Vp
Vp
Vp
Vp
Vp
lU
lU
lU
lU
Hw
GM
GM
GM
bh
Oo
bh
GM
Hw
Hw
Hw
RX
Hw
lU
lU
lU
lU
lU
Vp
Vp
Vp
Vp
Vp
Vp
"}
(10,1,1) = {"
Ef
Vp
Vp
Vp
Vp
Vp
Vp
lU
lU
lU
lU
Hw
Ca
GM
GM
GM
GM
GM
GM
GM
GM
GM
GM
Hw
lU
lU
lU
lU
lU
Vp
Vp
Vp
Vp
Vp
Vp
"}
(11,1,1) = {"
Vp
Vp
Vp
Vp
Vp
Vp
Vp
lU
lU
lU
lU
Hw
yi
GM
Bv
GM
GM
GM
GM
jn
jn
jn
jn
Xo
GM
GM
GM
GM
lU
Vp
Vp
Vp
Vp
Vp
Vp
"}
(12,1,1) = {"
Vp
Vp
Vp
Vp
Vp
Vp
Vp
lU
lU
lU
lU
Hw
bD
GM
Mq
Ma
GM
GM
GM
jn
jn
jn
jn
GM
GM
GM
gj
GM
lU
Vp
Vp
Vp
Vp
Vp
Vp
"}
(13,1,1) = {"
Vp
Vp
Vp
Vp
Vp
Vp
Vp
lU
lU
lU
lU
Hw
Gi
GM
ls
GM
GM
GM
GM
jn
jn
jn
jn
GM
GM
GM
GM
GM
lU
Vp
Vp
Vp
Vp
Vp
mT
"}
(14,1,1) = {"
Vp
Vp
Vp
Vp
Vp
Vp
Vp
lU
lU
lU
lU
Hw
GM
GM
GM
GM
GM
GM
GM
GM
GM
GM
GM
Hw
lU
lU
lU
lU
lU
Vp
Vp
Vp
Vp
mT
mT
"}
(15,1,1) = {"
mT
mT
mT
mT
Vp
Vp
Vp
lU
lU
lU
lU
Hw
GM
GM
GM
Xz
Oo
Xz
GM
GM
GM
GM
GM
Hw
lU
lU
lU
lU
lU
Vp
Vp
Vp
mT
mT
mT
"}
(16,1,1) = {"
mT
mT
mT
mT
Vp
Vp
Vp
lU
lU
lU
lU
Hw
Oo
GM
GM
Hw
Hw
Hw
Hw
Hw
GM
GM
GM
Hw
lU
lU
lU
lU
lU
Vp
Vp
Vp
mT
mT
mT
"}
(17,1,1) = {"
mT
mT
mT
mT
mT
Vp
Vp
Vp
lU
lU
lU
Hw
Hw
Hw
Hw
Hw
lU
lU
lU
Hw
GM
GM
Oo
Hw
lU
lU
lU
lU
Vp
Vp
Vp
Vp
mT
mT
mT
"}
(18,1,1) = {"
mT
mT
mT
mT
mT
mT
Vp
Vp
lU
lU
lU
lU
lU
lU
lU
lU
lU
Vp
lU
Hw
Hw
Hw
Hw
Hw
lU
lU
lU
lU
Vp
Vp
mT
Vp
Vp
mT
mT
"}
(19,1,1) = {"
mT
mT
mT
mT
mT
mT
Vp
Vp
lU
lU
lU
lU
lU
lU
lU
lU
lU
Vp
Vp
lU
lU
lU
lU
lU
lU
lU
lU
Vp
Vp
Vp
mT
mT
Vp
mT
mT
"}
(20,1,1) = {"
mT
mT
mT
mT
mT
mT
Vp
Vp
Vp
lU
Vp
Vp
lU
lU
lU
lU
Vp
Vp
lU
lU
lU
Vp
lU
lU
lU
lU
Vp
Vp
Vp
Vp
Vp
mT
mT
mT
mT
"}
(21,1,1) = {"
mT
mT
mT
mT
mT
mT
mT
Vp
Vp
Vp
Vp
Vp
Vp
Vp
Vp
Vp
Vp
Vp
Vp
Vp
Vp
Vp
Vp
yn
Vp
Vp
Vp
Vp
mT
mT
Vp
mT
mT
mT
mT
"}
(22,1,1) = {"
mT
mT
mT
mT
mT
mT
mT
Vp
Vp
Vp
Vp
Vp
Vp
Vp
Vp
Vp
Vp
Vp
Vp
Vp
Vp
Vp
Vp
Vp
Vp
Vp
Vp
mT
mT
mT
mT
Vp
mT
mT
mT
"}
(23,1,1) = {"
mT
mT
mT
mT
mT
mT
mT
mT
Vp
Vp
Vp
Vp
Vp
Vp
Vp
Vp
Vp
Vp
Vp
Vp
Vp
mT
Vp
Vp
Vp
Vp
Vp
Vp
mT
mT
mT
Vp
Vp
mT
mT
"}
(24,1,1) = {"
mT
mT
mT
mT
mT
mT
mT
mT
mT
mT
mT
mT
mT
mT
Vp
Vp
Vp
Vp
mT
Vp
mT
mT
mT
mT
Vp
mT
Vp
Vp
mT
mT
mT
mT
mT
mT
mT
"}
(25,1,1) = {"
mT
mT
mT
mT
mT
mT
mT
mT
mT
mT
mT
mT
mT
mT
mT
mT
Vp
mT
mT
mT
mT
mT
mT
mT
mT
mT
mT
mT
mT
mT
mT
mT
mT
mT
mT
"}

(1,1,2) = {"
mT
mT
mT
mT
mT
mT
mT
mT
mT
mT
mT
mT
mT
mT
Sc
Sc
Sc
Sc
Sc
Sc
mT
mT
mT
mT
mT
mT
mT
mT
mT
mT
mT
mT
mT
mT
mT
"}
(2,1,2) = {"
mT
Sc
Sc
Sc
Sc
mT
mT
mT
Sc
Sc
Sc
Sc
Sc
Sc
Sc
Sc
Sc
Sc
Sc
Sc
Sc
Sc
Sc
Sc
Sc
Sc
Sc
mT
mT
mT
mT
mT
mT
mT
mT
"}
(3,1,2) = {"
mT
Sc
Sc
Sc
mT
mT
Sc
Sc
Sc
Sc
Sc
Sc
Sc
Sc
Sc
Sc
Sc
Sc
Sc
Sc
Sc
Sc
Sc
Sc
Sc
Sc
Sc
Sc
mT
mT
mT
mT
mT
mT
mT
"}
(4,1,2) = {"
mT
mT
Sc
mT
mT
Sc
Sc
Sc
Sc
Sc
Sc
Sc
Sc
Sc
Sc
Sc
Sc
Sc
Sc
Sc
Sc
Sc
Sc
Sc
Sc
Sc
Sc
Sc
Sc
mT
mT
mT
mT
mT
Sc
"}
(5,1,2) = {"
mT
mT
Sc
Sc
Sc
Sc
Sc
Sc
Sc
Sc
Sc
Sc
Sc
Sc
Sc
Sc
Sc
Sc
Sc
Sc
Sc
Sc
Sc
Sc
Sc
Sc
Sc
Sc
Sc
Sc
mT
mT
mT
Sc
Sc
"}
(6,1,2) = {"
mT
mT
mT
Sc
Sc
Sc
Sc
Sc
Sc
Sc
Sc
UE
UE
UE
hf
UE
UE
UE
UE
UE
UE
UE
UE
UE
Sc
Sc
Sc
Sc
Sc
Sc
Sc
Sc
Sc
Sc
Sc
"}
(7,1,2) = {"
Sc
Sc
Sc
Sc
Sc
Sc
Sc
Sc
Sc
Sc
Sc
UE
Ve
iJ
iJ
iJ
UE
Re
iJ
Cn
Sc
nG
AT
UE
Sc
Sc
Sc
Sc
Sc
Sc
Sc
Sc
Sc
Sc
Sc
"}
(8,1,2) = {"
Sc
Sc
Sc
Sc
Sc
Sc
Sc
Sc
Sc
Sc
Sc
ns
XC
iJ
iJ
iJ
UE
iJ
iJ
Cn
Sc
iJ
iJ
UE
Sc
Sc
Sc
Sc
Sc
Sc
Sc
Sc
Sc
Sc
Sc
"}
(9,1,2) = {"
Sc
Sc
Sc
Sc
Sc
Sc
Sc
Sc
Sc
Sc
Sc
UE
lo
iJ
iJ
iJ
RX
iJ
iJ
iJ
iJ
iJ
iJ
UE
Sc
Sc
Sc
Sc
Sc
Sc
Sc
Sc
Sc
Sc
Sc
"}
(10,1,2) = {"
Sc
Sc
Sc
Sc
Sc
Sc
Sc
Sc
Sc
Sc
Sc
UE
UE
UE
UE
UE
UE
RX
UE
UE
UE
UE
UE
UE
Sc
Sc
Sc
Sc
Sc
Sc
Sc
Sc
Sc
Sc
Sc
"}
(11,1,2) = {"
Sc
Sc
Sc
Sc
Sc
Sc
Sc
Sc
Sc
Sc
Sc
UE
Ve
iJ
iJ
iJ
UE
Re
iJ
iJ
BZ
Pp
wE
UE
Sc
Sc
Sc
Sc
Sc
Sc
Sc
Sc
Sc
Sc
Sc
"}
(12,1,2) = {"
Sc
Sc
Sc
Sc
Sc
Sc
Sc
Sc
Sc
Sc
Sc
ns
XC
iJ
iJ
iJ
RX
iJ
iJ
iJ
iJ
iJ
iJ
Hl
Sc
Sc
Sc
Sc
Sc
Sc
Sc
Sc
Sc
Sc
Sc
"}
(13,1,2) = {"
Sc
Sc
Sc
Sc
Sc
Sc
Sc
Sc
Sc
Sc
Sc
UE
lo
iJ
iJ
iJ
UE
Re
iJ
dw
no
Mh
bz
UE
Sc
Sc
Sc
Sc
Sc
Sc
Sc
Sc
Sc
Sc
mT
"}
(14,1,2) = {"
Sc
Sc
Sc
Sc
Sc
Sc
Sc
Sc
Sc
Sc
Sc
UE
UE
UE
UE
UE
UE
RX
UE
UE
UE
UE
UE
UE
Sc
Sc
Sc
Sc
Sc
Sc
Sc
Sc
Sc
mT
mT
"}
(15,1,2) = {"
mT
mT
mT
mT
Sc
Sc
Sc
Sc
Sc
Sc
Sc
UE
Ve
iJ
iJ
iJ
RX
iJ
iJ
iJ
iJ
iJ
iJ
UE
Sc
Sc
Sc
Sc
Sc
Sc
Sc
Sc
mT
mT
mT
"}
(16,1,2) = {"
mT
mT
mT
mT
Sc
Sc
Sc
Sc
Sc
Sc
Sc
ns
XC
iJ
iJ
iJ
UE
iJ
iJ
iJ
iJ
FY
iJ
UE
Sc
Sc
Sc
Sc
Sc
Sc
Sc
Sc
mT
mT
mT
"}
(17,1,2) = {"
mT
mT
mT
mT
mT
Sc
Sc
Sc
Sc
Sc
Sc
UE
lo
iJ
iJ
iJ
UE
Re
iJ
iJ
iJ
iJ
iJ
UE
Sc
Sc
Sc
Sc
Sc
Sc
Sc
Sc
mT
mT
mT
"}
(18,1,2) = {"
mT
mT
mT
mT
mT
mT
Sc
Sc
Sc
Sc
Sc
UE
UE
UE
Rf
UE
UE
UE
UE
UE
UE
UE
UE
UE
Sc
Sc
Sc
Sc
Sc
Sc
mT
Sc
Sc
mT
mT
"}
(19,1,2) = {"
mT
mT
mT
mT
mT
mT
Sc
Sc
Sc
Sc
Sc
Sc
Sc
Sc
Sc
Sc
Sc
Sc
Sc
Sc
Sc
Sc
Sc
Sc
Sc
Sc
Sc
Sc
Sc
Sc
mT
mT
Sc
mT
mT
"}
(20,1,2) = {"
mT
mT
mT
mT
mT
mT
Sc
Sc
Sc
Sc
Sc
Sc
Sc
Sc
Sc
Sc
Sc
Sc
Sc
Sc
Sc
Sc
Sc
Sc
Sc
Sc
Sc
Sc
Sc
Sc
Sc
mT
mT
mT
mT
"}
(21,1,2) = {"
mT
mT
mT
mT
mT
mT
mT
Sc
Sc
Sc
Sc
Sc
Sc
Sc
Sc
Sc
Sc
Sc
Sc
Sc
Sc
Sc
Sc
Sc
Sc
Sc
Sc
Sc
mT
mT
Sc
mT
mT
mT
mT
"}
(22,1,2) = {"
mT
mT
mT
mT
mT
mT
mT
Sc
Sc
Sc
Sc
Sc
Sc
Sc
Sc
Sc
Sc
Sc
Sc
Sc
Sc
Sc
Sc
Sc
Sc
Sc
Sc
mT
mT
mT
mT
Sc
mT
mT
mT
"}
(23,1,2) = {"
mT
mT
mT
mT
mT
mT
mT
mT
Sc
Sc
Sc
Sc
Sc
Sc
Sc
Sc
Sc
Sc
Sc
Sc
Sc
mT
Sc
Sc
Sc
Sc
Sc
Sc
mT
mT
mT
Sc
Sc
mT
mT
"}
(24,1,2) = {"
mT
mT
mT
mT
mT
mT
mT
mT
mT
mT
mT
mT
mT
mT
Sc
Sc
Sc
Sc
mT
Sc
mT
mT
mT
mT
Sc
mT
Sc
Sc
mT
mT
mT
mT
mT
mT
mT
"}
(25,1,2) = {"
mT
mT
mT
mT
mT
mT
mT
mT
mT
mT
mT
mT
mT
mT
mT
mT
Sc
mT
mT
mT
mT
mT
mT
mT
mT
mT
mT
mT
mT
mT
mT
mT
mT
mT
mT
"}
