//MAP CONVERTED BY dmm2tgm.py THIS HEADER COMMENT PREVENTS RECONVERSION, DO NOT REMOVE
"aJ" = (
/obj/structure/bed/rogue/inn/double,
/obj/item/bedsheet/rogue/fabric_double,
/turf/open/floor/rogue/ruinedwood/turned,
/area/rogue/under/tomb/indoors)
"aZ" = (
/obj/structure/stairs/d{
	dir = 1
	},
/turf/open/floor/rogue/ruinedwood/turned,
/area/rogue/under/tomb/indoors)
"bK" = (
/obj/structure/fluff/walldeco/vinez/r,
/turf/open/floor/rogue/ruinedwood/turned,
/area/rogue/under/tomb/indoors)
"cE" = (
/obj/structure/table/wood,
/obj/structure/bars/pipe,
/obj/item/candle/yellow/lit,
/turf/open/floor/rogue/cobblerock,
/area/rogue/under/tomb/indoors)
"dA" = (
/mob/living/carbon/human/species/skeleton/npc/ambush,
/turf/open/floor/rogue/dirt,
/area/rogue/under/tomb/indoors)
"ek" = (
/obj/structure/closet/crate/chest/wicker,
/obj/item/reagent_containers/food/snacks/grown/wheat,
/obj/item/reagent_containers/food/snacks/grown/wheat,
/obj/item/reagent_containers/food/snacks/grown/wheat,
/obj/item/reagent_containers/food/snacks/grown/wheat,
/obj/item/reagent_containers/food/snacks/grown/wheat,
/obj/item/reagent_containers/food/snacks/grown/wheat,
/obj/item/reagent_containers/food/snacks/grown/wheat,
/turf/open/floor/rogue/ruinedwood/turned,
/area/rogue/under/tomb/indoors)
"ew" = (
/obj/structure/closet/crate/chest/wicker,
/obj/item/alch/horn,
/turf/open/floor/rogue/ruinedwood/turned,
/area/rogue/under/tomb/indoors)
"fQ" = (
/obj/machinery/light/rogue/campfire/longlived,
/turf/open/floor/rogue/ruinedwood/turned,
/area/rogue/under/tomb/indoors)
"gi" = (
/obj/structure/table/wood{
	dir = 1
	},
/obj/item/reagent_containers/food/snacks/rogue/breadslice,
/turf/open/floor/rogue/dirt,
/area/rogue/under/tomb/indoors)
"gQ" = (
/obj/structure/fluff/walldeco/vinez/r,
/turf/open/floor/rogue/blocks,
/area/rogue/under/tomb/indoors)
"hj" = (
/obj/structure/glowshroom{
	pixel_y = 12
	},
/turf/open/floor/rogue/cobblerock,
/area/rogue/under/tomb)
"iB" = (
/obj/structure/closet/crate/drawer/inn,
/obj/item/clothing/mask/cigarette/pipe/westman,
/obj/item/clothing/mask/cigarette/rollie/trippy,
/obj/item/clothing/mask/cigarette/rollie/trippy,
/obj/item/clothing/mask/cigarette/rollie/trippy{
	pixel_y = 8
	},
/obj/item/clothing/mask/cigarette/rollie/trippy{
	pixel_y = 14;
	pixel_x = -7
	},
/obj/item/clothing/mask/rogue/spectacles/golden,
/turf/open/floor/rogue/ruinedwood/turned,
/area/rogue/under/tomb/indoors)
"iK" = (
/turf/open/floor/rogue/ruinedwood/turned,
/area/rogue/under/tomb/indoors)
"iP" = (
/obj/structure/closet/crate/drawer/inn,
/turf/open/floor/rogue/ruinedwood/turned,
/area/rogue/under/tomb/indoors)
"jy" = (
/obj/structure/bed/rogue/shit,
/turf/open/floor/rogue/ruinedwood/turned,
/area/rogue/under/tomb/indoors)
"kq" = (
/obj/structure/fluff/walldeco/vinez/r,
/turf/open/floor/rogue/cobblerock,
/area/rogue/under/tomb)
"lo" = (
/obj/structure/mineral_door/bars,
/obj/effect/mapping_helpers/access/locker,
/turf/open/floor/rogue/ruinedwood/turned,
/area/rogue/under/tomb/indoors)
"ly" = (
/obj/structure/table/wood,
/obj/structure/bars/pipe,
/turf/open/floor/rogue/cobblerock,
/area/rogue/under/tomb/indoors)
"mC" = (
/obj/structure/stairs{
	dir = 4
	},
/turf/open/floor/rogue/ruinedwood/turned,
/area/rogue/under/tomb/indoors)
"mV" = (
/obj/structure/closet/crate/chest/wicker,
/obj/item/reagent_containers/food/snacks/grown/wheat,
/obj/item/reagent_containers/food/snacks/grown/wheat,
/obj/item/reagent_containers/food/snacks/grown/wheat,
/obj/item/reagent_containers/food/snacks/grown/wheat,
/obj/item/reagent_containers/food/snacks/grown/wheat,
/obj/item/reagent_containers/food/snacks/grown/wheat,
/turf/open/floor/rogue/ruinedwood/turned,
/area/rogue/under/tomb/indoors)
"oZ" = (
/obj/structure/closet/crate/chest/wicker,
/obj/item/reagent_containers/food/snacks/grown/wheat,
/obj/item/reagent_containers/food/snacks/grown/wheat,
/obj/item/reagent_containers/food/snacks/grown/wheat,
/obj/item/reagent_containers/food/snacks/grown/wheat,
/obj/item/reagent_containers/food/snacks/grown/wheat,
/obj/item/reagent_containers/food/snacks/rogue/raisins,
/obj/item/reagent_containers/food/snacks/rogue/raisins,
/obj/item/reagent_containers/food/snacks/rogue/raisins,
/obj/item/reagent_containers/food/snacks/rogue/raisins,
/obj/item/reagent_containers/food/snacks/rogue/raisins,
/obj/item/reagent_containers/food/snacks/rogue/raisins,
/turf/open/floor/rogue/ruinedwood/turned,
/area/rogue/under/tomb/indoors)
"qw" = (
/obj/effect/decal/remains/human,
/obj/structure/fluff/walldeco/vinez/l,
/turf/open/floor/rogue/ruinedwood/turned,
/area/rogue/under/tomb/indoors)
"qE" = (
/turf/open/floor/rogue/plank/h,
/area/rogue/under/tomb)
"rj" = (
/mob/living/carbon/human/species/skeleton/npc/ambush,
/turf/open/floor/rogue/ruinedwood/turned,
/area/rogue/under/tomb/indoors)
"sO" = (
/obj/structure/fluff/walldeco/vinez,
/turf/open/floor/rogue/dirt,
/area/rogue/under/tomb/indoors)
"sQ" = (
/turf/open/floor/rogue/dirt,
/area/rogue/under/tomb/indoors)
"tb" = (
/obj/structure/closet/crate/chest/wicker,
/obj/item/alch/golddust,
/obj/item/alch/silverdust,
/obj/item/alch/irondust,
/turf/open/floor/rogue/ruinedwood/turned,
/area/rogue/under/tomb/indoors)
"uk" = (
/obj/structure/table/wood{
	dir = 1
	},
/obj/item/reagent_containers/food/snacks/rogue/breadslice,
/turf/open/floor/rogue/ruinedwood/turned,
/area/rogue/under/tomb/indoors)
"uJ" = (
/turf/closed/wall/mineral/rogue/stone/moss,
/area/rogue/under/tomb/indoors)
"uP" = (
/turf/open/transparent/openspace,
/area/rogue/under/tomb/indoors)
"vx" = (
/obj/structure/table/optable,
/obj/structure/fluff/walldeco/chains{
	pixel_y = 21;
	pixel_x = 9
	},
/turf/open/floor/rogue/ruinedwood/turned,
/area/rogue/under/tomb/indoors)
"wO" = (
/obj/structure/well,
/turf/open/floor/rogue/cobblerock,
/area/rogue/under/tomb)
"wV" = (
/obj/structure/table/wood,
/obj/item/reagent_containers/food/snacks/rogue/breadslice,
/obj/item/reagent_containers/food/snacks/rogue/breadslice{
	pixel_y = 3;
	pixel_x = 2
	},
/obj/item/reagent_containers/food/snacks/rogue/breadslice{
	pixel_y = 7;
	pixel_x = 3
	},
/turf/open/floor/rogue/dirt,
/area/rogue/under/tomb/indoors)
"xM" = (
/obj/structure/table/wood{
	dir = 8
	},
/obj/structure/bars/pipe,
/turf/open/floor/rogue/cobblerock,
/area/rogue/under/tomb/indoors)
"xQ" = (
/obj/structure/closet/crate/chest/neu_fancy,
/obj/effect/mapping_helpers/access/locker,
/obj/item/rogueweapon/huntingknife/idagger/silver,
/obj/item/reagent_containers/powder/moondust_purest,
/obj/item/reagent_containers/powder/moondust_purest{
	pixel_y = -4;
	pixel_x = -3
	},
/obj/item/reagent_containers/powder/moondust_purest{
	pixel_x = 6
	},
/obj/item/reagent_containers/powder/ozium{
	pixel_y = -8;
	pixel_x = -1
	},
/turf/open/floor/rogue/ruinedwood/turned,
/area/rogue/under/tomb/indoors)
"yC" = (
/turf/open/floor/rogue/dirt,
/area/rogue/under/tomb)
"zf" = (
/obj/structure/closet/crate/chest/wicker,
/obj/item/alch/bonemeal,
/obj/item/alch/bonemeal,
/obj/item/alch/bonemeal,
/turf/open/floor/rogue/ruinedwood/turned,
/area/rogue/under/tomb/indoors)
"zM" = (
/turf/closed/mineral/rogue/bedrock,
/area/rogue/under/tomb)
"zU" = (
/obj/structure/glowshroom{
	pixel_y = 12
	},
/turf/open/floor/rogue/ruinedwood/turned,
/area/rogue/under/tomb/indoors)
"BV" = (
/obj/structure/table/wood/crafted,
/obj/item/millstone,
/obj/item/rogueweapon/huntingknife/cleaver{
	pixel_y = 7;
	pixel_x = -2
	},
/turf/open/floor/rogue/ruinedwood/turned,
/area/rogue/under/tomb/indoors)
"BY" = (
/obj/structure/glowshroom{
	pixel_y = 12
	},
/turf/open/floor/rogue/plank/h,
/area/rogue/under/tomb)
"Cl" = (
/obj/structure/ladder,
/turf/open/floor/rogue/ruinedwood/turned,
/area/rogue/under/tomb/indoors)
"Cr" = (
/obj/structure/glowshroom,
/turf/open/floor/rogue/ruinedwood/turned,
/area/rogue/under/tomb/indoors)
"Eo" = (
/obj/structure/mineral_door/wood/deadbolt,
/turf/open/floor/rogue/cobblerock,
/area/rogue/under/tomb/indoors)
"Eq" = (
/obj/structure/closet/crate/chest/wicker,
/obj/item/alch/magicdust,
/obj/item/alch/magicdust,
/turf/open/floor/rogue/ruinedwood/turned,
/area/rogue/under/tomb/indoors)
"Gd" = (
/obj/structure/glowshroom{
	pixel_y = 12
	},
/turf/open/floor/rogue/cobblerock,
/area/rogue/under/tomb/indoors)
"Gj" = (
/obj/structure/closet/crate/chest,
/obj/effect/mapping_helpers/access/locker,
/obj/item/reagent_containers/glass/bottle/rogue/healthpot,
/obj/item/reagent_containers/glass/bottle/rogue/healthpot,
/obj/item/reagent_containers/glass/bottle/rogue/healthpot{
	pixel_x = -8
	},
/turf/open/floor/rogue/ruinedwood/turned,
/area/rogue/under/tomb/indoors)
"HN" = (
/obj/structure/glowshroom{
	pixel_y = 11
	},
/turf/open/floor/rogue/ruinedwood/turned,
/area/rogue/under/tomb/indoors)
"Jt" = (
/obj/effect/landmark/chest_or_mimic,
/obj/item/reagent_containers/glass/bottle/rogue/healthpotnew,
/turf/open/floor/rogue/ruinedwood/turned,
/area/rogue/under/tomb/indoors)
"Lq" = (
/obj/structure/closet/crate/chest/wicker,
/obj/item/reagent_containers/food/snacks/grown/wheat,
/obj/item/reagent_containers/food/snacks/grown/wheat,
/obj/item/reagent_containers/food/snacks/grown/wheat,
/obj/item/reagent_containers/food/snacks/grown/wheat,
/turf/open/floor/rogue/ruinedwood/turned,
/area/rogue/under/tomb/indoors)
"Ns" = (
/obj/structure/mineral_door/wood/violet,
/obj/effect/mapping_helpers/access/locker,
/turf/open/floor/rogue/cobblerock,
/area/rogue/under/tomb/indoors)
"Nt" = (
/obj/item/clothing/head/roguetown/hatblu,
/mob/living/carbon/human/species/npc/deadite,
/turf/open/floor/rogue/ruinedwood/turned,
/area/rogue/under/tomb/indoors)
"NL" = (
/obj/structure/fluff/walldeco/vinez,
/turf/closed/wall/mineral/rogue/stone/moss,
/area/rogue/under/tomb/indoors)
"NS" = (
/obj/effect/dungeon_directional_helper/north,
/turf/open/floor/rogue/cobblerock,
/area/rogue/under/tomb)
"Oa" = (
/obj/structure/closet/crate/drawer/inn,
/obj/item/clothing/cloak/wickercloak,
/obj/item/clothing/gloves/roguetown/fingerless_leather,
/obj/item/clothing/head/roguetown/antlerhood,
/obj/item/clothing/mask/rogue/skullmask,
/turf/open/floor/rogue/ruinedwood/turned,
/area/rogue/under/tomb/indoors)
"Pg" = (
/obj/effect/dungeon_directional_helper/east,
/turf/open/floor/rogue/cobblerock,
/area/rogue/under/tomb)
"Pj" = (
/obj/machinery/light/rogue/oven/west,
/obj/machinery/light/rogue/oven/south,
/turf/open/floor/rogue/ruinedwood/turned,
/area/rogue/under/tomb/indoors)
"Pr" = (
/obj/item/candle/yellow/lit{
	pixel_y = 10;
	pixel_x = -10
	},
/obj/item/organ/eyes/night_vision/werewolf,
/obj/item/organ/eyes/night_vision/werewolf{
	pixel_y = -6;
	pixel_x = -12
	},
/obj/structure/table/wood/crafted,
/obj/item/storage/belt/rogue/surgery_bag/full{
	pixel_x = 7
	},
/turf/open/floor/rogue/ruinedwood/turned,
/area/rogue/under/tomb/indoors)
"QD" = (
/obj/structure/closet/crate/chest,
/obj/item/reagent_containers/food/snacks/rogue/meat/coppiette,
/turf/open/floor/rogue/ruinedwood/turned,
/area/rogue/under/tomb/indoors)
"Ra" = (
/obj/structure/bars,
/turf/open/floor/rogue/ruinedwood/turned,
/area/rogue/under/tomb/indoors)
"Rv" = (
/obj/structure/fluff/walldeco/vinez/offset,
/turf/open/floor/rogue/cobblerock,
/area/rogue/under/tomb)
"RK" = (
/obj/structure/closet/crate/chest/wicker,
/obj/item/reagent_containers/food/snacks/grown/wheat,
/obj/item/reagent_containers/food/snacks/grown/wheat,
/obj/item/reagent_containers/food/snacks/grown/wheat,
/obj/item/reagent_containers/food/snacks/grown/wheat,
/obj/item/reagent_containers/food/snacks/grown/wheat,
/obj/item/reagent_containers/food/snacks/rogue/raisins,
/obj/item/reagent_containers/food/snacks/rogue/raisins,
/obj/item/reagent_containers/food/snacks/rogue/raisins,
/obj/item/reagent_containers/food/snacks/rogue/raisins,
/obj/item/reagent_containers/food/snacks/rogue/raisins,
/turf/open/floor/rogue/ruinedwood/turned,
/area/rogue/under/tomb/indoors)
"RO" = (
/obj/item/reagent_containers/glass/bucket,
/turf/open/floor/rogue/cobblerock,
/area/rogue/under/tomb)
"TE" = (
/obj/structure/stairs{
	dir = 1
	},
/turf/open/floor/rogue/ruinedwood/turned,
/area/rogue/under/tomb/indoors)
"TX" = (
/obj/structure/glowshroom{
	pixel_y = 12
	},
/turf/open/floor/rogue/dirt,
/area/rogue/under/tomb/indoors)
"Uu" = (
/obj/structure/stairs/d{
	dir = 4
	},
/turf/open/floor/rogue/ruinedwood/turned,
/area/rogue/under/tomb/indoors)
"UM" = (
/turf/closed/mineral/rogue,
/area/rogue/under/tomb/indoors)
"Wu" = (
/turf/open/floor/rogue/cobblerock,
/area/rogue/under/tomb)
"XF" = (
/obj/effect/dungeon_directional_helper/west,
/turf/open/floor/rogue/cobblerock,
/area/rogue/under/tomb)
"Yf" = (
/turf/open/floor/rogue/blocks,
/area/rogue/under/tomb/indoors)
"Yi" = (
/turf/open/transparent/openspace,
/area/rogue/under/tomb)
"Yr" = (
/obj/item/alch/golddust,
/obj/structure/closet/crate/chest/neu_fancy,
/obj/effect/mapping_helpers/access/locker,
/obj/item/reagent_containers/powder/moondust_purest,
/obj/item/reagent_containers/powder/moondust_purest,
/obj/item/reagent_containers/powder/moondust_purest,
/turf/open/floor/rogue/ruinedwood/turned,
/area/rogue/under/tomb/indoors)
"YY" = (
/obj/effect/dungeon_directional_helper/south,
/turf/open/floor/rogue/cobblerock,
/area/rogue/under/tomb)

(1,1,1) = {"
zM
zM
zM
zM
zM
zM
zM
zM
zM
Wu
XF
zM
zM
zM
zM
zM
zM
zM
zM
zM
"}
(2,1,1) = {"
zM
Wu
Wu
Wu
Wu
Wu
Wu
Wu
Wu
Wu
Wu
yC
yC
yC
yC
yC
yC
yC
yC
zM
"}
(3,1,1) = {"
zM
Wu
Wu
Wu
Wu
Wu
Wu
Wu
Wu
Wu
Wu
yC
yC
yC
yC
yC
yC
yC
yC
zM
"}
(4,1,1) = {"
zM
Wu
Wu
uJ
uJ
sQ
sQ
uJ
uJ
Wu
Wu
uJ
uJ
UM
UM
uJ
uJ
yC
yC
zM
"}
(5,1,1) = {"
zM
Wu
Wu
uJ
iP
iK
iK
iK
uJ
Rv
Wu
UM
vx
qw
iK
Cl
uJ
yC
yC
zM
"}
(6,1,1) = {"
zM
Wu
Wu
UM
jy
sQ
sQ
iK
sQ
Wu
Wu
uJ
Pr
iK
iK
Gj
UM
yC
yC
zM
"}
(7,1,1) = {"
zM
Wu
Wu
UM
iK
Nt
iK
iK
UM
Rv
Wu
uJ
iK
iK
iK
Jt
UM
yC
yC
zM
"}
(8,1,1) = {"
zM
Wu
Wu
uJ
UM
uJ
TE
iK
uJ
Rv
Wu
uJ
iK
iK
bK
bK
uJ
yC
yC
zM
"}
(9,1,1) = {"
zM
Wu
Wu
uJ
UM
uJ
UM
uJ
Wu
kq
Wu
UM
cE
ly
xM
Ns
uJ
yC
yC
zM
"}
(10,1,1) = {"
Wu
Wu
Wu
Wu
Wu
Wu
Wu
Wu
Wu
wO
Wu
Eo
Yf
Yf
Yf
Yf
UM
yC
yC
Wu
"}
(11,1,1) = {"
NS
Wu
Wu
Wu
Wu
Wu
Wu
Wu
Wu
RO
Wu
uJ
sQ
Yf
gQ
Yf
uJ
yC
yC
YY
"}
(12,1,1) = {"
zM
Wu
Wu
uJ
UM
uJ
uJ
UM
uJ
Wu
Wu
uJ
sQ
uJ
UM
uJ
uJ
yC
yC
zM
"}
(13,1,1) = {"
zM
Wu
Wu
uJ
BV
iK
iK
iK
uJ
Wu
Wu
Wu
Wu
Wu
Wu
Wu
Wu
Wu
Wu
zM
"}
(14,1,1) = {"
zM
Wu
Wu
uJ
iK
dA
wV
iK
sO
Wu
Wu
Wu
Wu
Wu
hj
Wu
Wu
Wu
Wu
zM
"}
(15,1,1) = {"
zM
Wu
Wu
UM
mC
iK
gi
iK
NL
Wu
Wu
Wu
uJ
uJ
UM
UM
uJ
Wu
Wu
zM
"}
(16,1,1) = {"
zM
Wu
Wu
uJ
UM
Pj
uk
iK
sO
Wu
Wu
Wu
Gd
sQ
TX
QD
uJ
Wu
Wu
zM
"}
(17,1,1) = {"
zM
Wu
Wu
uJ
uJ
UM
uJ
uJ
uJ
Wu
Wu
Wu
uJ
sQ
Cl
Lq
UM
Wu
Wu
zM
"}
(18,1,1) = {"
zM
Wu
Wu
Wu
Wu
Wu
Wu
Wu
Wu
Wu
Wu
Wu
uJ
zU
iK
iK
UM
Wu
Wu
zM
"}
(19,1,1) = {"
zM
Wu
Wu
Wu
Wu
Wu
Wu
Wu
Wu
Wu
Wu
Wu
uJ
uJ
uJ
uJ
uJ
Wu
Wu
zM
"}
(20,1,1) = {"
zM
zM
zM
zM
zM
zM
zM
zM
zM
Wu
Pg
Wu
zM
zM
zM
zM
zM
zM
zM
zM
"}

(1,1,2) = {"
zM
zM
zM
zM
zM
zM
zM
zM
zM
Yi
Yi
zM
zM
zM
zM
zM
zM
zM
zM
zM
"}
(2,1,2) = {"
zM
Yi
Yi
Yi
Yi
Yi
Yi
Yi
Yi
Yi
Yi
Yi
Yi
Yi
Yi
Yi
Yi
Yi
Yi
zM
"}
(3,1,2) = {"
zM
Yi
Yi
Yi
Yi
Yi
Yi
Yi
Yi
Yi
Yi
Yi
Yi
Yi
Yi
Yi
Yi
Yi
Yi
zM
"}
(4,1,2) = {"
zM
Yi
Yi
uJ
uJ
uP
uP
uJ
uJ
Yi
Yi
UM
UM
UM
UM
UM
UM
Yi
Yi
zM
"}
(5,1,2) = {"
zM
Yi
Yi
uJ
jy
iK
jy
iK
uJ
Yi
Yi
UM
Eq
ew
Ra
Cl
UM
Yi
Yi
zM
"}
(6,1,2) = {"
zM
Yi
Yi
uJ
iK
iK
iK
iK
uP
Yi
Yi
UM
tb
rj
lo
iK
UM
Yi
Yi
zM
"}
(7,1,2) = {"
zM
Yi
Yi
uJ
iK
fQ
iK
iK
uJ
Yi
Yi
UM
zf
Yr
Ra
iK
UM
Yi
Yi
zM
"}
(8,1,2) = {"
zM
Yi
Yi
uJ
iK
aZ
uP
iK
uJ
Yi
Yi
UM
Ra
Ra
Ra
Cr
UM
Yi
Yi
zM
"}
(9,1,2) = {"
zM
Yi
Yi
uJ
uJ
uJ
uJ
uJ
Yi
Yi
Yi
UM
Oa
Cr
iK
iK
UM
Yi
Yi
zM
"}
(10,1,2) = {"
Yi
Yi
Yi
Yi
Yi
Yi
Yi
Yi
Yi
Yi
Yi
UM
iB
iK
Cr
Cr
UM
Yi
Yi
Yi
"}
(11,1,2) = {"
Yi
Yi
Yi
Yi
Yi
Yi
Yi
Yi
Yi
Yi
Yi
UM
aJ
iK
iK
xQ
UM
Yi
Yi
Yi
"}
(12,1,2) = {"
zM
Yi
Yi
UM
UM
UM
UM
UM
UM
Yi
Yi
UM
UM
UM
HN
UM
UM
Yi
Yi
zM
"}
(13,1,2) = {"
zM
Yi
Yi
UM
ek
mV
oZ
RK
UM
Yi
Yi
Yi
Yi
Yi
BY
Yi
Yi
Yi
Yi
zM
"}
(14,1,2) = {"
zM
Yi
Yi
UM
iK
iK
iK
iK
uP
Yi
Yi
Yi
Yi
Yi
qE
Yi
Yi
Yi
Yi
zM
"}
(15,1,2) = {"
zM
Yi
Yi
UM
uP
iK
iK
iK
UM
Yi
Yi
Yi
UM
UM
iK
UM
UM
Yi
Yi
zM
"}
(16,1,2) = {"
zM
Yi
Yi
UM
Uu
iK
iK
iK
uP
Yi
Yi
Yi
uP
uP
iK
zU
UM
Yi
Yi
zM
"}
(17,1,2) = {"
zM
Yi
Yi
UM
UM
UM
UM
UM
UM
Yi
Yi
Yi
UM
iK
Cl
iK
UM
Yi
Yi
zM
"}
(18,1,2) = {"
zM
Yi
Yi
Yi
Yi
Yi
Yi
Yi
Yi
Yi
Yi
Yi
UM
iK
iK
iK
UM
Yi
Yi
zM
"}
(19,1,2) = {"
zM
Yi
Yi
Yi
Yi
Yi
Yi
Yi
Yi
Yi
Yi
Yi
UM
UM
UM
UM
UM
Yi
Yi
zM
"}
(20,1,2) = {"
zM
zM
zM
zM
zM
zM
zM
zM
zM
Yi
Yi
Yi
zM
zM
zM
zM
zM
zM
zM
zM
"}
